NO maps/north.png

SO  ./maps/south.png

            C    10 ,  00100,            255

EA  maps/east.png
WE  maps/west.png
                 
 F       255 , 50, 255

111111111111111111111111
10001000011001000111111111
1111110001111 1000000001
101000000000000N000000001
1111111110110000011100001
100000000011110000011111111
11110111111111110111000001111111
1111111111111111111111111